"0" = empty
"1" = iceCube
"2" = snowBeeEgg
"3" = snowBee
"4" = diamond
"5" = player

0 1 0 0 0 1 0 0 0 0 0 1 0
0 1 0 1 1 2 1 3 1 1 0 4 0
0 0 0 1 0 0 0 0 0 1 0 1 0
0 1 1 1 0 1 1 1 0 1 0 2 0
0 0 0 0 0 1 0 0 0 1 0 0 0
1 2 1 2 1 1 0 1 1 1 0 3 0
0 0 0 0 0 0 5 1 0 1 0 1 0
0 1 1 2 1 1 1 1 0 4 0 1 1
0 1 0 0 0 0 0 1 0 0 0 0 0
0 1 1 1 1 1 0 1 0 1 1 1 0
0 1 0 0 0 0 0 1 0 1 0 0 0
0 1 0 1 1 1 1 1 0 1 1 3 1
0 0 0 1 0 0 0 1 0 0 0 0 0
1 1 0 1 0 4 0 1 1 1 1 1 0
0 0 0 0 0 1 0 0 0 0 0 0 0